[Options]
tile_size = 32, 32
num_tiles = 88, 50
start_tile = 85, 32
start_direction = left
regions = 1

[Layers]
    [[Data]]
    # X =   unwalkable
    # 1-100 = region number
    0  = XXXXXXXXXXXXXXXXXXXXXXXXXXXXXXXXXXXXXXXXXXXXXXXXXXXXXXXXXXXXXXXXXXXXXXXXXXXXXXXXXXXXXXXX
    1  = X11111111111111111111111111111111111111111111111111111111111111111111111111111111111111X
    2  = X11111111111111111111111111111111111111111111111111111111111111111111111111111111111111X
    3  = X11111111111111111111111111111111111111111111111111111111111111111111111111111111111111X
    4  = X11111111111111111111111111111111111111111111111111111111111111111111111111111111111111X
    5  = X11111111111111111111111111111111111111111111111111111111111111111111111111111111111111X
    6  = X11111111111111111111111111111111111111111111111111111111111111111111111111111111111111X
    7  = X11111111111111111111111111111111111111111111111111111111111111111111111111111111111111X
    8  = X11111111111111111111111111111111111111111111111111111111111111111111111111111111111111X
    9  = X11111111111111111111111111111111111111111111111111111111111111111111111111111111111111X
    10 = X11111111111111111111111111111111111111111111111111111111111111111111111111111111111111X
    11 = X11111111111111111111111111111111111111111111111111111111111111111111111111111111111111X
    12 = X11111111111111111111111111111111111111111111111111111111111111111111111111111111111111X
    13 = X11111111111111111111111111111111111111111111111111111111111111111111111111111111111111X
    14 = X11111111111111111111111111111111111111111111111111111111111111111111111111111111111111X
    15 = X11111111111111111111111111111111111111111111111111111111111111111111111111111111111111X
    16 = X11111111111111111111111111111111111111111111111111111111111111111111111111111111111111X
    17 = X11111111111111111111111111111111111111111111111111111111111111111111111111111111111111X
    18 = X11111111111111111111111111111111111111111111111111111111111111111111111111111111111111X
    19 = X11111111111111111111111111111111111111111111111111111111111111111111111111111111111111X
    20 = X11111111111111111111111111111111111111111111111111111111111111111111111111111111111111X
    21 = X11111111111111111111111111111111111111111111111111111111111111111111111111111111111111X
    22 = X11111111111111111111111111111111111111111111111111111111111111111111111111111111111111X
    23 = X11111111111111111111111111111111111111111111111111111111111111111111111111111111111111X
    24 = X11111111111111111111111111111111111111111111111111111111111111111111111111111111111111X
    25 = X11111111111111111111111111111111111111111111111111111111111111111111111111111111111111X
    26 = X11111111111111111111111111111111111111111111111111111111111111111111111111111111111111X
    27 = X11111111111111111111111111111111111111111111111111111111111111111111111111111111111111X
    28 = X11111111111111111111111111111111111111111111111111111111111111111111111111111111111111X
    29 = X11111111111111111111111111111111111111111111111111111111111111111111111111111111111111X
    30 = X11111111111111111111111111111111111111111111111111111111111111111111111111111111111111X
    31 = X11111111111111111111111111111111111111111111111111111111111111111111111111111111111111X
    32 = X11111111111111111111111111111111111111111111111111111111111111111111111111111111111111X
    33 = X11111111111111111111111111111111111111111111111111111111111111111111111111111111111111X
    34 = X11111111111111111111111111111111111111111111111111111111111111111111111111111111111111X
    35 = X11111111111111111111111111111111111111111111111111111111111111111111111111111111111111X
    36 = X11111111111111111111111111111111111111111111111111111111111111111111111111111111111111X
    37 = X11111111111111111111111111111111111111111111111111111111111111111111111111111111111111X
    38 = X11111111111111111111111111111111111111111111111111111111111111111111111111111111111111X
    39 = X11111111111111111111111111111111111111111111111111111111111111111111111111111111111111X
    40 = X11111111111111111111111111111111111111111111111111111111111111111111111111111111111111X
    41 = X11111111111111111111111111111111111111111111111111111111111111111111111111111111111111X
    42 = X11111111111111111111111111111111111111111111111111111111111111111111111111111111111111X
    43 = X11111111111111111111111111111111111111111111111111111111111111111111111111111111111111X
    44 = X11111111111111111111111111111111111111111111111111111111111111111111111111111111111111X
    45 = X11111111111111111111111111111111111111111111111111111111111111111111111111111111111111X
    46 = X11111111111111111111111111111111111111111111111111111111111111111111111111111111111111X
    47 = X11111111111111111111111111111111111111111111111111111111111111111111111111111111111111X
    48 = X11111111111111111111111111111111111111111111111111111111111111111111111111111111111111X
    49 = X11111111111111111111111111111111111111111111111111111111111111111111111111111111111111X
    50 = XXXXXXXXXXXXXXXXXXXXXXXXXXXXXXXXXXXXXXXXXXXXXXXXXXXXXXXXXXXXXXXXXXXXXXXXXXXXXXXXXXXXXXXX

    [[Terrain]]
    # g = grass
    # f = forest
    0  = gggggggggggggggggggggggggggggggggggggggggggggggggggggggggggggggggggggggggggggggggggggggg
    1  = gggggggggggggggggggggggggggggggggggggggggggggggggggggggggggggggggggggggggggggggggggggggg
    2  = gggggggggggggggggggggggggggggggggggggggggggggggggggggggggggggggggggggggggggggggggggggggg
    3  = gggggggggggggggggggggggggggggggggggggggggggggggggggggggggggggggggggggggggggggggggggggggg
    4  = gggggggggggggggggggggggggggggggggggggggggggggggggggggggggggggggggggggggggggggggggggggggg
    5  = gggggggggggggggggggggggggggggggggggggggggggggggggggggggggggggggggggggggggggggggggggggggg
    6  = gggggggggggggggggggggggggggggggggggggggggggggggggggggggggggggggggggggggggggggggggggggggg
    7  = gggggggggggggggggggggggggggggggggggggggggggggggggggggggggggggggggggggggggggggggggggggggg
    8  = gggggggggggggggggggggggggggggggggggggggggggggggggggggggggggggggggggggggggggggggggggggggg
    9  = gggggggggggggggggggggggggggggggggggggggggggggggggggggggggggggggggggggggggggggggggggggggg
    10 = gggggggggggggggggggggggggggggggggggggggggggggggggggggggggggggggggggggggggggggggggggggggg
    11 = gggggggggggggggggggggggggggggggggggggggggggggggggggggggggggggggggggggggggggggggggggggggg
    12 = gggggggggggggggggggggggggggggggggggggggggggggggggggggggggggggggggggggggggggggggggggggggg
    13 = gggggggggggggggggggggggggggggggggggggggggggggggggggggggggggggggggggggggggggggggggggggggg
    14 = gggggggggggggggggggggggggggggggggggggggggggggggggggggggggggggggggggggggggggggggggggggggg
    15 = gggggggggggggggggggggggggggggggggggggggggggggggggggggggggggggggggggggggggggggggggggggggg
    16 = gggggggggggggggggggggggggggggggggggggggggggggggggggggggggggggggggggggggggggggggggggggggg
    17 = gggggggggggggggggggggggggggggggggggggggggggggggggggggggggggggggggggggggggggggggggggggggg
    18 = gggggggggggggggggggggggggggggggggggggggggggggggggggggggggggggggggggggggggggggggggggggggg
    19 = gggggggggggggggggggggggggggggggggggggggggggggggggggggggggggggggggggggggggggggggggggggggg
    20 = gggggggggggggggggggggggggggggggggggggggggggggggggggggggggggggggggggggggggggggggggggggggg
    21 = gggggggggggggggggggggggggggggggggggggggggggggggggggggggggggggggggggggggggggggggggggggggg
    22 = gggggggggggggggggggggggggggggggggggggggggggggggggggggggggggggggggggggggggggggggggggggggg
    23 = gggggggggggggggggggggggggggggggggggggggggggggggggggggggggggggggggggggggggggggggggggggggg
    24 = gggggggggggggggggggggggggggggggggggggggggggggggggggggggggggggggggggggggggggggggggggggggg
    25 = gggggggggggggggggggggggggggggggggggggggggggggggggggggggggggggggggggggggggggggggggggggggg
    26 = gggggggggggggggggggggggggggggggggggggggggggggggggggggggggggggggggggggggggggggggggggggggg
    27 = gggggggggggggggggggggggggggggggggggggggggggggggggggggggggggggggggggggggggggggggggggggggg
    28 = gggggggggggggggggggggggggggggggggggggggggggggggggggggggggggggggggggggggggggggggggggggggg
    29 = gggggggggggggggggggggggggggggggggggggggggggggggggggggggggggggggggggggggggggggggggggggggf
    30 = gggggggggggggggggggggggggggggggggggggggggggggggggggggggggggggggggggggggggggggggggggggggg
    31 = ggggggggggggggggggggggggggggggggggggggggggggggggggggggggggggggggggggggggggggggggggffgggg
    32 = gggggggggggggggggggggggggggggggggggggggggggggggggggggggggggggggggggggggggggggggggfgfffgg
    33 = ggggggggggggggggggggggggggggggggggggggggggggggggggggggggggggggggggggggggggggggggffffffgg
    34 = ggggggggggggggggggggggggggggggggggggggggggggggggggggggggggggggggggggggggggggggggfffffffg
    35 = ggggggggggggggggggggggggggggggggggggggggggggggggggggggggggggggggggggggggggggggggffgggffg
    36 = ggggggggggggggggggggggggggggggggggggggggggggggggggggggggggggggggggggggggggggggggffggfffg
    37 = ggggggggggggggggggggggggggggggggggggggggggggggggggggggggggggggggggggggggggggggggggfffffg
    38 = gggggggggggggggggggggggggggggggggggggggggggggggggggggggggggggggggggggggggggggggggggfgggg
    39 = gggggggggggggggggggggggggggggggggggggggggggggggggggggggggggggggggggggggggggggggggggggggg
    40 = gggggggggggggggggggggggggggggggggggggggggggggggggggggggggggggggggggggggggggggggggggggggg
    41 = gggggggggggggggggggggggggggggggggggggggggggggggggggggggggggggggggggggggggggggggggggggggg
    42 = gggggggggggggggggggggggggggggggggggggggggggggggggggggggggggggggggggggggggggggggggggggggg
    43 = gggggggggggggggggggggggggggggggggggggggggggggggggggggggggggggggggggggggggggggggggggggggg
    44 = gggggggggggggggggggggggggggggggggggggggggggggggggggggggggggggggggggggggggggggggggggggggg
    45 = gggggggggggggggggggggggggggggggggggggggggggggggggggggggggggggggggggggggggggggggggggggggg
    46 = gggggggggggggggggggggggggggggggggggggggggggggggggggggggggggggggggggggggggggggggggggggggg
    47 = gggggggggggggggggggggggggggggggggggggggggggggggggggggggggggggggggggggggggggggggggggggggg
    48 = gggggggggggggggggggggggggggggggggggggggggggggggggggggggggggggggggggggggggggggggggggggggg
    49 = gggggggggggggggggggggggggggggggggggggggggggggggggggggggggggggggggggggggggggggggggggggggg
    50 = gggggggggggggggggggggggggggggggggggggggggggggggggggggggggggggggggggggggggggggggggggggggg

    [[Objects]]
    0  = ........................................................................................
    1  = ........................................................................................
    2  = ........................................................................................
    3  = ........................................................................................
    4  = ........................................................................................
    5  = ........................................................................................
    6  = ........................................................................................
    7  = ........................................................................................
    8  = ........................................................................................
    9  = ........................................................................................
    10 = ........................................................................................
    11 = ........................................................................................
    12 = ........................................................................................
    13 = ........................................................................................
    14 = ........................................................................................
    15 = ........................................................................................
    16 = ........................................................................................
    17 = ........................................................................................
    18 = ........................................................................................
    19 = ........................................................................................
    20 = ........................................................................................
    21 = ........................................................................................
    22 = ........................................................................................
    23 = ........................................................................................
    24 = ........................................................................................
    25 = ........................................................................................
    26 = ........................................................................................
    27 = ........................................................................................
    28 = ........................................................................................
    29 = ........................................................................................
    30 = ........................................................................................
    31 = ...................................................................................d....
    32 = ..................................................................................a.....
    33 = ..................................................................................l.....
    34 = ........................................................................................
    35 = ........................................................................................
    36 = ................................................................................c.......
    37 = ......................................................................................e.
    38 = ........................................................................................
    39 = ........................................................................................
    40 = ........................................................................................
    41 = ........................................................................................
    42 = ........................................................................................
    43 = ........................................................................................
    44 = ........................................................................................
    45 = ........................................................................................
    46 = ........................................................................................
    47 = ........................................................................................
    48 = ........................................................................................
    49 = ........................................................................................
    50 = ........................................................................................
