[Options]
tile_set = 'world'
tile_size = 32, 32
num_tiles = 88, 9
start_tile = 85, 1
start_direction = left
regions = 1

[Layers]
    [[Data]]
    # X         unwalkable
    # other     region
    0  = XXXXXXXXXXXXXXXXXXXXXXXXXXXXXXXXXXXXXXXXXXXXXXXXXXXXXXXXXXXXXXXXXXXXXXXXXXXXXXXXXXXXXXXX
    1  = X11111111111111111111111111111111111111111111111111111111111111111111111111111111111111X
    2  = X11111111111111111111111111111111111111111111111111111111111111111111111111111111111111X
    3  = X11111111111111111111111111111111111111111111111111111111111111111111111111111111111111X
    4  = X11111111111111111111111111111111111111111111111111111111111111111111111111111111111111X
    5  = X11111111111111111111111111111111111111111111111111111111111111111111111111111111111111X
    6  = X11111111111111111111111111111111111111111111111111111111111111111111111111111111111111X
    7  = X11111111111111111111111111111111111111111111111111111111111111111111111111111111111111X
    8  = XXXXXXXXXXXXXXXXXXXXXXXXXXXXXXXXXXXXXXXXXXXXXXXXXXXXXXXXXXXXXXXXXXXXXXXXXXXXXXXXXXXXXXXX

    [[Terrain]]
    # g     grass
    # f     forest
    0 =  gggggggggggggggggggggggggggggggggggggggggggggggggggggggggggggggggggggggggggggggggggggggf
    1 =  ggggggggggggggggggggggggggggggggggggggggggggggggggggggggggggggggggggggggggggggggggffgggg
    2 =  ggggggggggggggggggggggggggggggggggggggggggggggggggggggggggggggggggggggggggggffgggfgfffgg
    3 =  gggggggggggggggggggggggggggggggggggggggggggggggggggggggggggggggggggggggggggfggfffffgffgg
    4 =  gggggggggggggggggggggggggggggggggggggggggggggggggggggggggggggggggggggggggfffgffffgggggfg
    5 =  ggggggggggggggggggggggggggggggggggggggggggggggggggggggggggggggggggggggggffgfffgfffgggfff
    6 =  ggggggggggggggggggggggggggggggggggggggggggggggggggggggggggggggggggggggggggggggggffggggfg
    7 =  ggggggggggggggggggggggggggggggggggggggggggggggggggggggggggggggggggggggggggggggggggfffffg
    8 =  gggggggggggggggggggggggggggggggggggggggggggggggggggggggggggggggggggggggggggggggggggfgggg

    [[Objects]]
    0 =  ........................................................................................
    1 =  ...................................................................................b....
    2 =  ..................................................................................a.....
    3 =  ..................................................................................l.....
    4 =  ........................................................................................
    5 =  ........................................................................................
    6 =  ................................................................................a.......
    7 =  ......................................................................................e.
    8 =  ........................................................................................
