[Options]
tile_set = 'cave'
tile_size = 32, 32
num_tiles = 88, 50
start_tile = 5, 5
start_direction = left
regions = 1

[Layers]
    [[Data]]
    # X         unwalkable
    # other     region
    0  = XXXXXXXXXXXXXXXXXXXXXXXXXXXXXXXXXXXXXXXXXXXXXXXXXXXXXXXXXXXXXXXXXXXXXXXXXXXXXXXXXXXXXXXX
    1  = X11111111111111111111111111111111111111111111111111111111111111111111111111111111111111X
    2  = X11111111111111111111111111111111111111111111111111111111111111111111111111111111111111X
    3  = X11111111111111111111111111111111111111111111111111111111111111111111111111111111111111X
    4  = X11111111111111111111111111111111111111111111111111111111111111111111111111111111111111X
    5  = X11111111111111111111111111111111111111111111111111111111111111111111111111111111111111X
    6  = X11111111111111111111111111111111111111111111111111111111111111111111111111111111111111X
    7  = X11111111111111111111111111111111111111111111111111111111111111111111111111111111111111X
    8  = X11111111111111111111111111111111111111111111111111111111111111111111111111111111111111X
    9  = X11111111111111111111111111111111111111111111111111111111111111111111111111111111111111X
    10 = X11111111111111111111111111111111111111111111111111111111111111111111111111111111111111X
    11 = X11111111111111111111111111111111111111111111111111111111111111111111111111111111111111X
    12 = X11111111111111111111111111111111111111111111111111111111111111111111111111111111111111X
    13 = X11111111111111111111111111111111111111111111111111111111111111111111111111111111111111X
    14 = X11111111111111111111111111111111111111111111111111111111111111111111111111111111111111X
    15 = X11111111111111111111111111111111111111111111111111111111111111111111111111111111111111X
    16 = X11111111111111111111111111111111111111111111111111111111111111111111111111111111111111X
    17 = X11111111111111111111111111111111111111111111111111111111111111111111111111111111111111X
    18 = X11111111111111111111111111111111111111111111111111111111111111111111111111111111111111X
    19 = X11111111111111111111111111111111111111111111111111111111111111111111111111111111111111X
    20 = X11111111111111111111111111111111111111111111111111111111111111111111111111111111111111X
    21 = X11111111111111111111111111111111111111111111111111111111111111111111111111111111111111X
    22 = X11111111111111111111111111111111111111111111111111111111111111111111111111111111111111X
    23 = X11111111111111111111111111111111111111111111111111111111111111111111111111111111111111X
    24 = X11111111111111111111111111111111111111111111111111111111111111111111111111111111111111X
    25 = X11111111111111111111111111111111111111111111111111111111111111111111111111111111111111X
    26 = X11111111111111111111111111111111111111111111111111111111111111111111111111111111111111X
    27 = X11111111111111111111111111111111111111111111111111111111111111111111111111111111111111X
    28 = X11111111111111111111111111111111111111111111111111111111111111111111111111111111111111X
    29 = X11111111111111111111111111111111111111111111111111111111111111111111111111111111111111X
    30 = X11111111111111111111111111111111111111111111111111111111111111111111111111111111111111X
    31 = X11111111111111111111111111111111111111111111111111111111111111111111111111111111111111X
    32 = X11111111111111111111111111111111111111111111111111111111111111111111111111111111111111X
    33 = X11111111111111111111111111111111111111111111111111111111111111111111111111111111111111X
    34 = X11111111111111111111111111111111111111111111111111111111111111111111111111111111111111X
    35 = X11111111111111111111111111111111111111111111111111111111111111111111111111111111111111X
    36 = X11111111111111111111111111111111111111111111111111111111111111111111111111111111111111X
    37 = X11111111111111111111111111111111111111111111111111111111111111111111111111111111111111X
    38 = X11111111111111111111111111111111111111111111111111111111111111111111111111111111111111X
    39 = X11111111111111111111111111111111111111111111111111111111111111111111111111111111111111X
    40 = X11111111111111111111111111111111111111111111111111111111111111111111111111111111111111X
    41 = X11111111111111111111111111111111111111111111111111111111111111111111111111111111111111X
    42 = X11111111111111111111111111111111111111111111111111111111111111111111111111111111111111X
    43 = X11111111111111111111111111111111111111111111111111111111111111111111111111111111111111X
    44 = X11111111111111111111111111111111111111111111111111111111111111111111111111111111111111X
    45 = X11111111111111111111111111111111111111111111111111111111111111111111111111111111111111X
    46 = X11111111111111111111111111111111111111111111111111111111111111111111111111111111111111X
    47 = X11111111111111111111111111111111111111111111111111111111111111111111111111111111111111X
    48 = X11111111111111111111111111111111111111111111111111111111111111111111111111111111111111X
    49 = X11111111111111111111111111111111111111111111111111111111111111111111111111111111111111X
    50 = XXXXXXXXXXXXXXXXXXXXXXXXXXXXXXXXXXXXXXXXXXXXXXXXXXXXXXXXXXXXXXXXXXXXXXXXXXXXXXXXXXXXXXXX

    [[Terrain]]
    # g     floor
    0  = cccccccccccccccccccccccccccccccccccccccccccccccccccccccccccccccccccccccccccccccccccccccc
    1  = cccccccccccccccccccccccccccccccccccccccccccccccccccccccccccccccccccccccccccccccccccccccc
    2  = cccccccccccccccccccccccccccccccccccccccccccccccccccccccccccccccccccccccccccccccccccccccc
    3  = cccccccccccccccccccccccccccccccccccccccccccccccccccccccccccccccccccccccccccccccccccccccc
    4  = cccccccccccccccccccccccccccccccccccccccccccccccccccccccccccccccccccccccccccccccccccccccc
    5  = cccccccccccccccccccccccccccccccccccccccccccccccccccccccccccccccccccccccccccccccccccccccc
    6  = ccccccccccFccccccccccccccccccccccccccccccccccccccccccccccccccccccccccccccccccccccccccccc
    7  = cccccccccccccccccccccccccccccccccccccccccccccccccccccccccccccccccccccccccccccccccccccccc
    8  = cccccccccccccccccccccccccccccccccccccccccccccccccccccccccccccccccccccccccccccccccccccccc
    9  = cccccccccccccccccccccccccccccccccccccccccccccccccccccccccccccccccccccccccccccccccccccccc
    10 = cccccccccccccccccccccccccccccccccccccccccccccccccccccccccccccccccccccccccccccccccccccccc
    11 = cccccccccccccccccccccccccccccccccccccccccccccccccccccccccccccccccccccccccccccccccccccccc
    12 = cccccccccccccccccccccccccccccccccccccccccccccccccccccccccccccccccccccccccccccccccccccccc
    13 = cccccccccccccccccccccccccccccccccccccccccccccccccccccccccccccccccccccccccccccccccccccccc
    14 = cccccccccccccccccccccccccccccccccccccccccccccccccccccccccccccccccccccccccccccccccccccccc
    15 = cccccccccccccccccccccccccccccccccccccccccccccccccccccccccccccccccccccccccccccccccccccccc
    16 = cccccccccccccccccccccccccccccccccccccccccccccccccccccccccccccccccccccccccccccccccccccccc
    17 = cccccccccccccccccccccccccccccccccccccccccccccccccccccccccccccccccccccccccccccccccccccccc
    18 = cccccccccccccccccccccccccccccccccccccccccccccccccccccccccccccccccccccccccccccccccccccccc
    19 = cccccccccccccccccccccccccccccccccccccccccccccccccccccccccccccccccccccccccccccccccccccccc
    20 = cccccccccccccccccccccccccccccccccccccccccccccccccccccccccccccccccccccccccccccccccccccccc
    21 = cccccccccccccccccccccccccccccccccccccccccccccccccccccccccccccccccccccccccccccccccccccccc
    22 = cccccccccccccccccccccccccccccccccccccccccccccccccccccccccccccccccccccccccccccccccccccccc
    23 = cccccccccccccccccccccccccccccccccccccccccccccccccccccccccccccccccccccccccccccccccccccccc
    24 = cccccccccccccccccccccccccccccccccccccccccccccccccccccccccccccccccccccccccccccccccccccccc
    25 = cccccccccccccccccccccccccccccccccccccccccccccccccccccccccccccccccccccccccccccccccccccccc
    26 = cccccccccccccccccccccccccccccccccccccccccccccccccccccccccccccccccccccccccccccccccccccccc
    27 = cccccccccccccccccccccccccccccccccccccccccccccccccccccccccccccccccccccccccccccccccccccccc
    28 = cccccccccccccccccccccccccccccccccccccccccccccccccccccccccccccccccccccccccccccccccccccccc
    29 = cccccccccccccccccccccccccccccccccccccccccccccccccccccccccccccccccccccccccccccccccccccccc
    30 = cccccccccccccccccccccccccccccccccccccccccccccccccccccccccccccccccccccccccccccccccccccccc
    31 = cccccccccccccccccccccccccccccccccccccccccccccccccccccccccccccccccccccccccccccccccccccccc
    32 = cccccccccccccccccccccccccccccccccccccccccccccccccccccccccccccccccccccccccccccccccccccccc
    33 = cccccccccccccccccccccccccccccccccccccccccccccccccccccccccccccccccccccccccccccccccccccccc
    34 = cccccccccccccccccccccccccccccccccccccccccccccccccccccccccccccccccccccccccccccccccccccccc
    35 = cccccccccccccccccccccccccccccccccccccccccccccccccccccccccccccccccccccccccccccccccccccccc
    36 = cccccccccccccccccccccccccccccccccccccccccccccccccccccccccccccccccccccccccccccccccccccccc
    37 = cccccccccccccccccccccccccccccccccccccccccccccccccccccccccccccccccccccccccccccccccccccccc
    38 = cccccccccccccccccccccccccccccccccccccccccccccccccccccccccccccccccccccccccccccccccccccccc
    39 = cccccccccccccccccccccccccccccccccccccccccccccccccccccccccccccccccccccccccccccccccccccccc
    40 = cccccccccccccccccccccccccccccccccccccccccccccccccccccccccccccccccccccccccccccccccccccccc
    41 = cccccccccccccccccccccccccccccccccccccccccccccccccccccccccccccccccccccccccccccccccccccccc
    42 = cccccccccccccccccccccccccccccccccccccccccccccccccccccccccccccccccccccccccccccccccccccccc
    43 = cccccccccccccccccccccccccccccccccccccccccccccccccccccccccccccccccccccccccccccccccccccccc
    44 = cccccccccccccccccccccccccccccccccccccccccccccccccccccccccccccccccccccccccccccccccccccccc
    45 = cccccccccccccccccccccccccccccccccccccccccccccccccccccccccccccccccccccccccccccccccccccccc
    46 = cccccccccccccccccccccccccccccccccccccccccccccccccccccccccccccccccccccccccccccccccccccccc
    47 = cccccccccccccccccccccccccccccccccccccccccccccccccccccccccccccccccccccccccccccccccccccccc
    48 = cccccccccccccccccccccccccccccccccccccccccccccccccccccccccccccccccccccccccccccccccccccccc
    49 = cccccccccccccccccccccccccccccccccccccccccccccccccccccccccccccccccccccccccccccccccccccccc
    50 = cccccccccccccccccccccccccccccccccccccccccccccccccccccccccccccccccccccccccccccccccccccccc

    [[Objects]]
    0  = ........................................................................................
    1  = ........................................................................................
    2  = ........................................................................................
    3  = ........................................................................................
    4  = ........................................................................................
    5  = ........................................................................................
    6  = ........................................................................................
    7  = ........................................................................................
    8  = ........................................................................................
    9  = ........................................................................................
    10 = ........................................................................................
    11 = ........................................................................................
    12 = ........................................................................................
    13 = ........................................................................................
    14 = ........................................................................................
    15 = ........................................................................................
    16 = ........................................................................................
    17 = ........................................................................................
    18 = ........................................................................................
    19 = ........................................................................................
    20 = ........................................................................................
    21 = ........................................................................................
    22 = ........................................................................................
    23 = ........................................................................................
    24 = ........................................................................................
    25 = ........................................................................................
    26 = ........................................................................................
    27 = ........................................................................................
    28 = ........................................................................................
    29 = ........................................................................................
    30 = ........................................................................................
    31 = ........................................................................................
    32 = ........................................................................................
    33 = ........................................................................................
    34 = ........................................................................................
    35 = ........................................................................................
    36 = ........................................................................................
    37 = ........................................................................................
    38 = ........................................................................................
    39 = ........................................................................................
    40 = ........................................................................................
    41 = ........................................................................................
    42 = ........................................................................................
    43 = ........................................................................................
    44 = ........................................................................................
    45 = ........................................................................................
    46 = ........................................................................................
    47 = ........................................................................................
    48 = ........................................................................................
    49 = ........................................................................................
    50 = ........................................................................................
